TAILLE:10:10
LIGNE:1:0:0:0:1:0:0:0:1:1
LIGNE:1:0:1:0:1:0:1:0:1:1
LIGNE:1:0:1:0:0:0:1:0:0:0
LIGNE:1:0:1:1:1:0:1:0:1:0
LIGNE:0:0:0:0:0:0:0:0:1:0
LIGNE:0:1:1:1:0:1:1:0:1:0
LIGNE:0:0:0:0:0:0:0:0:1:0
LIGNE:0:1:1:0:1:1:1:0:1:0
LIGNE:0:1:1:0:0:0:0:0:1:0
LIGNE:0:0:0:0:1:1:1:0:0:0
